  X X X X   X     X 
X         X X XXX X 
  XX XX XXX X X X X 
 X X   X    X X   X 
 X X XX  X X   X X  
 X X X  X X  X X  X 
   X  X    XX  X X  
X X  X XXX XX XX   X
 X  X    X    X XX  
   X  X X XXXX    X 
X X XX    X   XX X  
      X X   X    XX 
XXX X XXXXXXXX XX   
   XX   X   X  X  XX
 X   XX   X  X X X  
  XX  X X  X X   XX 
 X  X  X  X  X XX   
 XX  X X X  XX X  X 
  X X T X  XX   X X 
X X   X S X   X   X 