       S X
 X XXX XT 
 X X X  X 
  X   X X 
X   X X X 
X X XX  X 
   X   X  
 XX  XXX X
X   X     
  XX  X X 